                              
         D      R      D      
         HZZZZZZZZZZZZZH       
         H             H      
     D   S      M      S   D  
    ZHZZZZZZZZZZZZZZZZZZZZZHZ 
     H                     H  
     S     D        D      S  
   ZZZZZZZZHZZZZZZZZHZZZZZZZZZ
           H        H         
  D   E B IS        S E      D
ZZHZZZZZZZZZ        ZZZZZZZZZH
  H                          H
  S     D              D     S
  ZZZZZZHZZZZZZZZZZZZZZHZZZZZZ
        H              H      
        S     D        S C    
 ZZZZZZZZZZZZZHZZZZZZZZZZZZZ  
              H               
       D      S      D        
      ZHZZZZZZZZZZZZZHZZZZS   
       H             H        
 D    ES             S      D 
 HZZZZZZZZZZZZZZZZZZZZZZZZZZH 
 H                          H 
 S   P                      S 
ZZZZZZZZZZZZZZZZZZZZZZZZZZZZZZ
                              
                              
                              